45 45
500 600
0  0  0  0  0  0  0  0  0  0  0  0  0  0  0  0  0  0  0  0  0  0  0  0  0  0  0  0  0  0  0  0  0  0  0  0  0  0  0  0  0  0  0  0  0
0  0  0  0  0  0  0  0  0  0  0  0  0  0  0  0  0  0  0  0  0  0  0  0  0  0  0  0  0  0  0  0  0  0  0  0  0  0  0  0  0  0  0  0  0
0  0  0  0  0  0  11 11 1  1  1  1  1  1  11 1  1  11 11 1  1  1  1  1  1  1  1  1  1  1  1  1  1  1  0  0  0  0  0  0  0  0  0  0  0
0  0  0  0  0  11 11 1  1  1  1  1  1  11 1  11 11 1  1  1  1  1  1  1  1  1  1  1  1  1  1  1  1  1  1  1  0  0  0  0  0  0  0  0  0
0  0  0  0  11 1  1  22 22 2  22 22 2  2  2  2  2  2  2  2  2  2  2  2  2  2  2  2  2  2  2  2  2  2  11 11 1  0  0  0  0  0  0  0  0
0  0  0  11 1  1  22 22 2  22 2  22 2  2  2  2  2  12 2  2  2  2  2  2  22 22 2  2  2  22 2  2  22 2  2  1  1  0  0  0  0  0  0  0  0
0  0  11 1  1  22 22 2  22 2  2  2  2  2  2  2  2  2  2  2  22 2  2  2  2  22 22 2  2  2  22 22 2  2  2  1  1  1  0  0  0  0  0  0  0
0  0  1  11 2  2  2  2  2  3  3  3  3  3  3  3  3  3  3  3  3  3  23 3  3  3  3  3  3  3  3  22 2  2  2  2  1  11 0  0  0  0  0  0  0
0  0  1  11 2  2  2  2  3  3  3  3  3  3  3  3  3  3  3  33 3  3  33 3  3  3  3  3  3  3  3  3  2  2  2  2  1  1  0  0  0  0  0  0  0
0  0  11 11 2  2  2  3  3  3  3  3  3  3  3  3  3  3  3  3  3  3  3  3  3  3  3  3  3  3  3  3  3  2  2  22 11 1  0  0  0  0  0  0  0
0  0  1  1  2  2  2  3  3  3  3  3  3  4  4  4  4  4  4  4  4  4  4  4  4  4  4  3  3  3  33 3  3  2  2  22 11 1  0  0  0  0  0  0  0
0  0  1  11 2  2  2  3  3  3  3  3  4  4  4  4  4  4  4  4  4  4  4  4  4  4  4  4  3  3  3  3  3  2  2  22 1  1  0  0  0  0  0  0  0
0  0  1  1  2  2  22 3  3  3  3  4  4  4  4  4  4  4  4  4  4  4  4  4  4  4  4  4  4  3  3  33 3  2  2  22 1  1  0  0  0  0  0  0  0
0  0  1  1  2  2  2  3  33 3  4  4  44 4  4  4  4  4  4  4  4  4  4  4  4  4  4  4  4  4  3  3  3  22 2  22 11 1  0  0  0  0  0  0  0
0  0  1  11 2  2  2  33 3  3  4  4  4  4  4  4  4  4  4  4  4  4  4  4  4  4  4  4  4  4  3  3  3  22 2  22 1  1  0  0  0  0  0  0  0
0  0  1  1  2  2  2  3  3  3  4  4  4  4  4  4  4  4  4  4  4  4  4  4  4  4  4  4  4  4  3  3  3  2  2  22 11 1  0  0  0  0  0  0  0
0  0  1  1  2  2  2  3  33 3  44 4  44 4  44 44 44 4  44 44 4  4  44 44 44 4  44 44 4  4  43 3  3  22 2  22 1  1  0  0  0  0  0  0  0
0  0  1  11 2  2  22 3  3  3  44 4  44 4  44 4  4  4  44 4  44 4  44 4  4  4  44 4  44 4  43 3  3  2  2  22 11 1  0  0  0  0  0  0  0
0  0  11 11 2  2  2  3  3  3  44 44 44 4  44 44 44 4  44 4  44 4  44 44 44 4  44 44 4  4  43 3  3  22 2  22 1  1  0  0  0  0  0  0  0
0  0  11 11 2  2  2  33 3  3  44 4  44 4  44 4  4  4  44 4  44 4  4  4  44 4  44 4  4  4  43 3  3  2  22 22 1  11 0  0  0  0  0  0  0
0  0  1  11 12 2  2  3  3  3  44 4  44 4  44 44 44 4  44 44 4  4  44 44 44 4  44 4  4  4  43 3  3  2  2  22 1  11 0  0  0  0  0  0  0
0  0  1  11 2  2  2  3  33 3  4  4  4  4  4  4  4  4  4  4  4  4  4  4  4  4  4  4  4  4  3  3  3  2  2  22 1  11 0  0  0  0  0  0  0
0  0  1  1  2  2  2  3  3  3  4  4  4  4  4  4  4  4  4  4  4  4  4  4  4  4  4  4  4  4  3  3  3  2  2  22 1  1  0  0  0  0  0  0  0
0  0  11 1  2  2  2  33 3  3  4  4  4  4  44 4  44 4  44 44 44 4  44 44 44 4  4  4  4  4  3  3  3  2  2  22 11 1  0  0  0  0  0  0  0
0  0  11 1  2  2  2  3  33 3  4  4  4  4  44 44 4  4  44 4  4  4  4  4  44 4  4  4  4  4  3  3  3  2  2  22 11 1  0  0  0  0  0  0  0
0  0  11 1  12 2  2  33 3  3  4  4  4  4  44 4  4  4  44 44 44 4  44 44 44 4  4  4  4  4  3  3  3  2  2  22 11 11 0  0  0  0  0  0  0
0  0  1  1  2  22 2  3  3  3  4  4  4  4  44 44 4  4  44 4  44 4  4  4  44 4  4  4  4  4  3  3  3  2  2  22 1  1  0  0  0  0  0  0  0
0  0  1  1  2  22 2  3  33 3  3  4  4  4  44 4  44 4  44 44 44 4  44 44 44 4  4  4  4  3  3  3  3  2  2  22 1  1  0  0  0  0  0  0  0
0  0  1  11 2  2  2  3  33 3  3  3  4  4  4  4  4  4  4  4  4  4  4  4  4  4  4  4  3  3  3  3  3  2  2  22 1  1  0  0  0  0  0  0  0
0  0  1  11 2  2  22 3  3  3  33 3  3  4  4  4  4  4  4  4  4  4  4  4  4  4  4  3  3  33 33 3  3  2  2  22 1  1  0  0  0  0  0  0  0
0  0  11 11 2  2  2  3  3  3  3  33 3  3  3  3  3  3  3  3  3  3  3  3  3  3  3  3  3  3  3  33 3  2  2  22 1  1  0  0  0  0  0  0  0
0  0  1  11 2  2  2  2  3  3  3  3  3  3  3  3  3  3  3  3  3  3  3  3  33 3  3  3  3  3  3  3  2  2  2  22 1  1  0  0  0  0  0  0  0
0  0  1  1  2  2  2  2  2  3  3  3  3  3  3  33 33 3  3  3  33 3  3  3  3  3  3  3  3  3  3  2  2  2  2  22 1  1  0  0  0  0  0  0  0
0  0  1  1  1  2  22 22 2  2  2  2  2  22 22 2  2  22 22 2  2  2  2  2  2  2  2  2  22 2  2  2  2  2  2  1  1  1  0  0  0  0  0  0  0
0  0  0  1  1  1  2  22 22 2  2  2  2  2  2  22 2  22 2  2  2  2  22 22 22 2  2  2  2  2  22 2  2  2  22 1  1  0  0  0  0  0  0  0  0
0  0  0  0  1  1  1  2  2  2  2  2  2  2  22 2  2  22 2  2  2  2  2  2  2  2  2  2  2  2  2  22 2  2  1  11 1  0  0  0  0  0  0  0  0
0  0  0  0  0  1  1  1  1  1  11 1  1  1  1  1  1  1  11 11 1  11 1  1  1  1  1  1  1  1  1  1  1  1  1  1  0  0  0  0  0  0  0  0  0
0  0  0  0  0  0  11 1  11 11 1  1  1  1  1  1  1  1  1  1  11 1  1  1  1  1  1  1  11 1  1  1  1  1  0  0  0  0  0  0  0  0  0  0  0
0  0  0  0  0  0  0  0  0  0  0  0  0  0  0  0  0  0  0  0  0  0  0  0  0  0  0  0  0  0  0  0  0  0  0  0  0  0  0  0  0  0  0  0  0
0  0  0  0  0  0  0  0  0  0  0  0  0  0  0  0  0  0  0  0  0  0  0  0  0  0  0  0  0  0  0  0  0  0  0  0  0  0  0  0  0  0  0  0  0
0  0  0  0  0  0  0  0  0  0  0  0  0  0  0  0  0  0  0  0  0  0  0  0  0  0  0  0  0  0  0  0  0  0  0  0  0  0  0  0  0  0  0  0  0
0  0  0  0  0  0  0  0  0  0  0  0  0  0  0  0  0  0  0  0  0  0  0  0  0  0  0  0  0  0  0  0  0  0  0  0  0  0  0  0  0  0  0  0  0
0  0  0  0  0  0  0  0  0  0  0  0  0  0  0  0  0  0  0  0  0  0  0  0  0  0  0  0  0  0  0  0  0  0  0  0  0  0  0  0  0  0  0  0  0
0  0  0  0  0  0  0  0  0  0  0  0  0  0  0  0  0  0  0  0  0  0  0  0  0  0  0  0  0  0  0  0  0  0  0  0  0  0  0  0  0  0  0  0  0
0  0  0  0  0  0  0  0  0  0  0  0  0  0  0  0  0  0  0  0  0  0  0  0  0  0  0  0  0  0  0  0  0  0  0  0  0  0  0  0  0  0  0  0  0
